90,90,90,90,90,90,90,90,90,90,90,90,90,90,90,90,90,90,90,90,90,90,90,90,90
90,90,90,90,90,90,90,90,90,90,90,90,90,90,90,90,90,90,90,90,90,90,90,90,90
90,90,90,90,90,90,90,90,90,90,90,90,90,90,90,90,90,90,90,90,90,90,90,90,90
90,90,90,90,90,90,90,90,90,90,90,90,90,90,90,90,90,90,90,90,90,90,90,90,90
90,90,90,90,90,90,120,120,120,90,90,90,90,90,90,90,90,90,90,90,90,90,90,90,120
90,90,90,90,90,90,120,120,120,90,90,90,90,90,90,90,90,90,90,90,90,90,90,120,120
90,90,90,90,90,90,120,120,120,90,90,90,90,90,90,90,90,90,90,90,90,90,90,120,120
90,90,90,90,90,90,120,120,120,120,120,90,90,90,90,90,90,90,90,90,90,90,90,120,120
120,120,120,120,120,120,120,120,120,120,120,90,90,90,90,90,90,90,90,90,90,90,90,120,120
120,120,120,120,120,120,120,120,120,120,120,90,90,90,90,90,90,90,90,90,90,90,90,120,120
120,120,120,120,120,120,120,120,120,120,120,90,90,90,90,90,90,90,90,90,90,90,90,120,120
120,120,120,120,120,120,120,120,120,120,120,120,90,90,90,90,90,90,90,90,90,90,120,120,120
120,120,120,120,120,120,120,120,120,120,120,120,120,90,90,90,90,90,90,90,90,120,120,120,120
120,120,120,120,120,120,120,120,120,120,120,120,120,90,90,90,90,90,90,90,90,120,120,120,120
120,120,120,120,120,120,120,120,120,120,120,120,120,120,120,120,120,120,120,120,120,120,120,120,120
120,120,120,120,120,120,120,120,120,120,120,120,120,120,120,120,120,120,120,120,120,120,120,120,120
120,120,120,120,120,120,120,120,120,120,120,120,120,120,120,120,120,120,120,120,120,120,120,120,120
120,120,120,120,120,120,120,120,120,120,120,120,120,120,120,120,120,120,120,120,120,120,120,120,120
120,120,120,120,120,120,120,120,120,120,120,120,120,120,120,120,120,120,120,120,120,120,120,120,120
120,120,120,120,120,120,120,120,120,120,120,120,120,120,120,120,120,120,120,120,120,120,120,120,120
120,120,120,120,120,120,120,120,120,120,120,120,120,120,120,120,120,120,120,120,120,120,120,120,120
120,120,120,120,120,120,120,120,120,120,120,120,120,120,120,120,120,120,120,120,120,120,120,120,120
120,120,120,120,120,120,120,120,120,120,120,120,120,120,120,120,120,120,120,120,120,120,120,120,120
120,120,120,120,120,120,120,120,120,120,120,120,120,120,120,120,120,120,120,120,120,120,120,120,120
120,120,120,120,120,120,120,120,120,120,120,120,120,120,120,120,120,120,120,120,120,120,120,120,120
