120,120,120,120,120,120,120,120,120,120,120,120,120,120,120,120,120,120,120,120,120,120,120,120,120
120,120,120,120,120,120,120,120,120,120,120,120,120,120,120,120,120,120,120,120,120,120,120,120,120
120,120,120,120,120,120,120,120,120,120,120,120,120,120,120,120,120,120,120,120,120,120,120,120,120
120,120,120,120,120,120,120,120,120,120,120,120,120,120,120,120,120,120,120,120,120,120,120,120,120
120,120,120,120,120,120,120,120,120,120,120,120,120,120,120,120,120,120,120,120,120,120,120,120,120
120,120,120,120,120,120,120,120,120,120,120,120,120,120,120,120,120,120,120,120,120,120,120,120,120
120,120,120,120,120,120,120,120,120,120,120,120,120,120,120,120,120,120,120,120,120,120,120,90,90
120,120,120,120,120,120,120,120,120,120,120,120,90,90,90,90,120,120,120,120,120,120,120,90,90
120,120,120,120,120,120,120,120,120,120,120,120,90,90,90,90,120,120,120,120,120,120,120,90,90
120,120,120,120,120,120,120,120,120,120,90,90,90,90,90,90,120,120,120,120,120,120,120,90,90
120,120,120,120,120,120,120,120,120,90,90,90,90,90,90,90,90,90,120,120,120,120,120,90,90
120,120,120,120,120,120,120,120,120,90,90,90,90,90,90,90,90,90,120,120,120,120,120,90,90
120,120,120,120,120,120,90,90,90,90,90,90,90,90,90,90,90,90,120,120,120,120,120,90,90
120,120,120,120,120,120,90,90,90,90,90,90,90,90,90,90,90,90,90,90,120,120,120,90,90
90,90,90,90,90,90,90,90,90,90,90,90,90,90,90,90,90,90,90,90,120,120,90,90,90
90,90,90,90,90,90,90,90,90,90,90,90,90,90,90,90,90,90,90,90,120,120,90,90,90
0,0,0,90,90,90,90,90,300,0,0,90,90,0,0,90,90,90,90,90,90,90,90,90,90
0,0,0,90,90,90,90,90,90,90,0,0,90,0,0,90,90,90,90,90,90,90,90,90,90
0,0,0,90,90,90,90,90,90,90,0,0,0,0,0,90,90,90,90,90,90,90,90,90,90
0,0,0,90,90,90,90,8,8,90,90,90,0,0,0,90,90,90,90,90,90,0,0,0,0
0,0,0,90,90,90,90,0,0,90,90,90,0,0,0,90,90,90,90,90,90,0,90,90,90
0,0,0,0,90,90,90,0,0,90,90,90,0,0,0,90,90,90,90,90,90,0,90,90,90
0,0,0,0,90,90,90,0,0,90,90,90,0,0,0,90,90,90,90,0,0,0,90,90,90
0,0,0,0,90,90,90,0,0,90,90,90,0,0,0,90,90,90,90,90,90,0,90,90,90
0,0,0,0,90,90,0,0,0,90,90,90,0,0,0,0,90,90,90,0,0,0,90,90,90
