13,13,13,13,13,13,13,13,13,13,13,13,13,13,12,12,12,12,12,12,12,12,12,12,12,
13,13,13,13,13,13,13,13,13,13,13,13,13,13,12,12,12,12,12,12,12,12,12,12,12,
13,13,13,13,13,13,13,13,13,13,13,13,13,13,12,12,12,12,12,12,12,12,12,12,12,
13,13,13,13,13,13,13,13,13,13,13,13,13,12,12,12,12,12,12,12,12,12,12,12,12,
13,13,13,13,13,13,13,13,13,13,13,13,13,12,12,12,12,12,12,12,12,12,12,12,12,
13,13,13,13,13,13,13,13,13,12,12,12,12,12,12,12,12,12,12,12,12,12,12,12,12,
13,13,13,13,13,13,13,13,13,12,12,12,12,12,12,12,12,12,12,12,12,12,12,12,12,
13,13,13,13,13,13,13,12,12,12,12,12,12,12,12,12,12,12,12,12,12,12,12,12,12,
13,13,13,13,13,13,13,12,12,12,12,12,12,12,12,12,12,12,12,12,12,12,12,12,12,
13,13,13,13,13,13,12,12,12,12,12,12,12,12,12,12,12,12,12,12,12,12,12,12,12,
13,13,13,13,13,13,12,12,12,12,12,12,12,12,12,12,12,12,12,12,12,12,12,12,12,
13,13,13,13,13,13,12,12,12,12,12,12,12,12,12,12,12,2,2,2,2,2,2,2,2,
13,13,13,13,13,13,12,12,12,12,12,12,12,12,12,12,12,2,9,9,9,9,9,9,9,
13,13,13,13,13,13,12,12,12,12,12,12,12,12,12,12,12,12,9,9,9,9,9,9,9,
13,13,13,13,13,13,12,12,12,12,12,2,12,12,12,12,12,12,9,9,9,9,9,9,9,
13,13,13,13,13,13,12,12,12,12,12,2,9,9,9,9,12,12,9,9,9,9,12,9,9,
13,13,13,13,13,12,12,12,12,2,2,2,9,9,9,9,9,12,12,9,9,9,9,9,9,
13,13,13,13,13,12,12,12,12,2,2,9,9,9,9,9,9,12,9,9,9,9,9,9,9,
13,13,13,13,13,12,12,12,12,2,2,9,9,9,9,9,9,9,9,9,9,12,12,9,9,
13,13,13,13,13,12,12,12,12,2,2,9,9,9,9,9,9,9,9,9,9,9,12,9,9,
13,13,13,13,13,12,12,12,12,2,2,2,9,9,9,9,9,9,9,9,9,9,12,9,9,
13,13,13,13,13,12,12,12,12,2,2,2,9,9,9,9,9,9,9,9,9,9,9,9,9,
13,13,13,13,13,12,12,12,12,2,2,2,9,9,9,9,9,9,9,12,9,9,9,9,9,
13,13,13,13,13,12,12,12,12,12,12,2,9,9,9,9,12,9,9,9,9,9,9,9,9,
13,13,13,13,13,12,12,12,12,12,12,2,9,9,9,9,9,9,9,9,9,9,9,9,9,
