90,90,0,0,0,0,90,0,90,90,90,120,120,120,120,120,120,120,120,120,120,120,120,120,120
0,0,0,0,0,0,0,0,0,90,120,120,120,120,120,120,120,120,120,120,120,120,120,120,120
0,0,0,0,0,90,90,90,90,90,120,120,120,120,120,120,120,120,120,120,120,120,120,120,120
90,0,0,90,90,90,90,90,90,90,120,120,120,120,120,120,120,120,120,120,120,120,120,120,120
0,90,90,90,90,8,8,90,120,120,120,120,120,120,120,120,120,120,120,120,120,120,120,120,120
0,0,90,90,90,0,8,90,120,120,120,120,120,120,120,120,120,120,120,120,120,120,120,120,120
90,0,90,0,0,0,0,90,120,120,120,120,120,120,120,120,120,120,120,120,120,120,120,120,120
90,0,90,0,0,0,0,90,120,120,120,120,120,120,120,120,120,120,120,120,120,120,120,120,120
90,0,90,0,0,0,0,90,120,120,120,120,120,120,120,120,120,120,120,120,120,120,120,120,120
0,90,90,0,0,0,0,90,120,120,120,120,120,120,120,120,120,120,120,120,120,120,120,120,120
0,0,0,0,0,0,0,90,120,120,120,120,120,120,120,120,120,120,120,120,120,120,120,120,120
90,90,0,0,0,0,0,90,120,120,120,120,120,120,120,120,120,120,120,120,120,120,120,120,120
90,90,90,0,0,90,90,90,120,120,120,120,120,120,120,120,120,120,120,120,120,120,120,120,120
90,90,90,90,0,90,90,90,120,120,120,120,120,120,120,120,120,120,120,120,120,120,120,120,120
0,199,90,90,0,90,90,90,120,120,120,120,120,120,120,120,120,120,120,120,120,120,120,120,120
0,90,90,90,0,90,90,90,120,120,120,120,120,120,120,120,120,120,120,120,120,120,120,120,120
0,90,0,0,0,90,120,120,120,120,120,120,120,120,120,120,120,120,120,120,120,120,120,120,120
20,90,20,90,90,90,120,120,120,120,120,120,120,120,120,120,120,120,120,120,120,120,120,120,120
20,20,20,90,90,120,120,120,120,120,120,120,120,120,120,120,120,120,120,120,120,120,120,120,120
90,90,90,90,90,120,120,120,120,120,120,120,120,120,120,120,120,120,120,120,120,120,120,120,120
120,120,120,120,120,120,120,120,120,120,120,120,120,120,120,120,120,120,120,120,120,120,120,120,120
120,120,120,120,120,120,120,120,120,120,120,120,120,120,120,120,120,120,120,120,120,120,120,120,120
120,120,120,120,120,120,120,120,120,120,120,120,120,120,120,120,120,120,120,120,120,120,120,120,120
120,120,120,120,120,120,120,120,120,120,120,120,120,120,120,120,120,120,120,120,120,120,120,120,120
120,120,120,120,120,120,120,120,120,120,120,120,120,120,120,120,120,120,120,120,120,120,120,120,120
