41,41,41,41,41,41,41,41,41,41,41,41,41,41,41,41,41,41,41,41,41,41,41,41,41
41,41,41,41,41,41,41,41,41,41,41,41,41,41,41,41,41,41,41,41,41,41,41,41,41
41,41,41,41,41,41,41,41,41,41,41,41,41,41,41,41,41,41,41,41,41,41,41,41,41
41,41,41,41,41,41,41,41,41,41,41,41,41,41,41,41,41,41,41,41,41,41,41,41,41
41,41,41,41,41,41,21,21,21,41,41,41,41,41,41,41,41,41,41,41,41,41,41,41,21
41,41,41,41,41,41,21,21,21,41,41,41,41,41,41,41,41,41,41,41,41,41,41,21,21
41,41,41,41,41,41,21,21,21,41,41,41,41,41,41,41,41,41,41,41,41,41,41,21,21
41,41,41,41,41,41,21,21,21,21,21,41,41,41,41,41,41,41,41,41,41,41,41,21,21
21,21,21,21,21,21,21,21,21,21,21,41,41,41,41,41,41,41,41,41,41,41,41,21,21
21,21,21,21,21,21,21,21,21,21,21,41,41,41,41,41,41,41,41,41,41,41,41,21,21
21,21,21,21,21,21,21,21,21,21,21,41,41,41,41,41,41,41,41,41,41,41,41,21,21
21,21,21,21,21,21,21,21,21,21,21,21,41,41,41,41,41,41,41,41,41,41,21,21,21
21,21,21,21,21,21,21,21,21,21,21,21,21,41,41,41,41,41,41,41,41,21,21,21,21
21,21,21,21,21,21,21,21,21,21,21,21,21,41,41,41,41,41,41,41,41,21,21,21,21
21,21,21,21,21,21,21,21,21,21,21,21,21,21,21,21,21,21,21,21,21,21,21,21,21
21,21,21,21,21,21,21,21,21,21,21,21,21,21,21,21,21,21,21,21,21,21,21,21,21
21,21,21,21,21,21,21,21,21,21,21,21,21,21,21,21,21,21,21,21,21,21,21,21,21
21,21,21,21,21,21,21,21,21,21,21,21,21,21,21,21,21,21,21,21,21,21,21,21,21
21,21,21,21,21,21,21,21,21,21,21,21,21,21,21,21,21,21,21,21,21,21,21,21,21
21,21,21,21,21,21,21,21,21,21,21,21,21,21,21,21,21,21,21,21,21,21,21,21,21
21,21,21,21,21,21,21,21,21,21,21,21,21,21,21,21,21,21,21,21,21,21,21,21,21
21,21,21,21,21,21,21,21,21,21,21,21,21,21,21,21,21,21,21,21,21,21,21,21,21
21,21,21,21,21,21,21,21,21,21,21,21,21,21,21,21,21,21,21,21,21,21,21,21,21
21,21,21,21,21,21,21,21,21,21,21,21,21,21,21,21,21,21,21,21,21,21,21,21,21
21,21,21,21,21,21,21,21,21,21,21,21,21,21,21,21,21,21,21,21,21,21,21,21,21
