12,12,12,12,12,12,12,12,12,12,12,12,12,12,12,12,12,12,12,2,2,2,2,2,12
12,12,12,12,12,12,12,12,12,12,12,12,12,12,12,12,12,12,2,2,2,12,12,12,12
12,12,12,12,12,12,12,12,12,12,12,12,12,12,12,12,12,12,12,12,2,12,12,12,12
12,12,12,12,12,12,12,12,12,12,12,12,12,12,12,12,12,12,12,12,2,12,12,12,12
12,12,12,12,12,12,12,12,12,12,12,12,12,12,12,12,12,12,12,12,2,12,12,12,12
12,12,12,12,12,12,12,12,12,12,12,12,12,12,12,12,12,12,12,12,2,12,12,12,12
12,12,12,12,12,12,12,12,12,12,12,12,12,12,12,12,12,12,12,12,2,12,12,12,12
2,2,2,2,2,2,2,2,2,2,2,2,2,2,2,2,2,2,2,2,2,12,12,12,12
12,12,12,12,12,12,12,12,7,7,7,7,7,7,7,7,12,12,12,12,2,12,12,12,12
12,12,12,12,12,12,12,12,7,7,7,7,7,7,7,7,12,12,12,12,2,12,12,12,12
12,12,12,12,12,12,12,12,12,7,7,7,7,7,7,12,12,12,12,12,2,12,12,12,12
12,12,12,12,12,12,12,12,12,12,7,7,7,7,12,12,12,12,12,12,2,12,12,12,12
11,12,12,12,12,12,12,12,12,12,7,7,7,7,12,12,12,12,12,12,2,12,12,12,12
11,11,12,12,12,12,12,12,12,12,12,7,7,12,12,12,12,12,12,12,2,12,12,12,12
11,11,12,12,12,12,12,12,12,12,12,19,2,2,2,2,2,2,2,2,2,12,12,12,12
11,11,11,12,12,12,12,12,12,12,12,12,12,12,12,12,12,12,12,12,12,12,12,12,12
11,11,11,11,12,12,12,12,12,12,12,12,12,12,12,12,12,12,12,11,11,11,11,11,11
11,11,11,11,12,12,12,12,12,12,12,12,12,12,12,12,12,12,12,11,11,11,11,11,11
11,11,11,11,12,12,12,12,12,12,12,12,12,12,12,12,12,12,12,11,11,11,11,11,11
11,11,11,11,11,11,12,12,12,12,12,12,12,12,12,12,12,11,11,11,11,11,11,11,11
11,11,11,11,11,11,12,12,12,12,12,12,12,12,12,12,11,11,11,11,11,11,11,11,11
11,11,11,11,11,11,11,11,11,11,11,11,11,11,11,11,11,11,11,11,11,11,11,11,11
11,11,11,11,11,11,11,11,11,11,11,11,11,11,11,11,11,11,11,11,11,11,11,11,11
11,11,11,11,11,11,11,11,11,11,11,11,11,11,11,11,11,11,11,11,11,11,11,11,11
11,11,11,11,11,11,11,11,11,11,11,11,11,11,11,11,11,11,11,11,11,11,11,11,11
