14,14,14,14,14,12,12,12,12,12,12,12,12,11,11,11,11,11,11,11,11,11,11,11,11
14,14,14,14,14,14,12,12,12,12,12,12,12,11,11,11,11,11,11,11,11,11,11,11,11
12,14,14,14,14,14,14,12,12,12,12,12,12,11,11,11,11,11,11,11,11,11,11,11,11
12,14,14,14,14,14,14,14,12,12,12,12,12,11,11,11,11,11,11,11,11,11,11,11,11
14,14,14,14,14,14,14,14,12,12,12,12,11,11,11,11,11,11,11,11,11,11,11,11,11
14,14,14,14,14,14,14,12,12,12,12,11,11,11,11,11,11,11,11,11,11,11,11,11,11
14,14,14,14,14,14,12,12,12,12,12,11,11,11,11,11,11,11,11,11,11,11,11,11,11
12,14,14,14,14,14,12,12,12,12,12,11,11,11,11,11,11,11,11,11,11,11,11,11,11
12,12,14,14,14,12,12,12,12,12,11,11,11,11,11,11,11,11,11,11,11,11,11,11,11
14,12,12,12,12,12,12,12,12,11,11,11,11,11,11,11,11,11,11,11,11,11,11,11,11
12,12,12,12,11,11,11,11,11,11,11,11,11,11,11,11,11,11,11,11,11,11,11,11,11
12,12,11,11,11,11,11,11,11,11,11,11,11,11,11,11,11,11,11,11,11,11,11,11,11
11,11,11,11,11,11,11,11,11,11,11,11,11,11,11,11,11,11,11,11,11,11,11,11,11
11,11,11,11,11,11,11,11,11,11,11,11,11,11,11,11,11,11,11,11,11,11,11,11,11
11,11,11,11,11,11,11,11,11,11,11,11,11,11,11,11,11,11,11,11,11,11,11,11,11
11,11,11,11,11,11,11,11,11,11,11,11,11,11,11,11,11,11,11,11,11,11,11,11,11
11,11,11,11,11,11,11,11,11,11,11,11,11,11,11,11,11,11,11,11,11,11,11,11,11
11,11,11,11,11,11,11,11,11,11,11,11,11,11,11,11,11,11,11,11,11,11,11,11,11
11,11,11,11,11,11,11,11,11,11,11,11,11,11,11,11,11,11,11,11,11,11,11,11,11
11,11,11,11,11,11,11,11,11,11,11,11,11,11,11,11,11,11,11,11,11,11,11,11,11
11,11,11,11,11,11,11,11,11,11,11,11,11,11,11,11,11,11,11,11,11,11,11,11,11
11,11,11,11,11,11,11,11,11,11,11,11,11,11,11,11,11,11,11,11,11,11,11,11,11
11,11,11,11,11,11,11,11,11,11,11,11,11,11,11,11,11,11,11,11,11,11,11,11,11
11,11,11,11,11,11,11,11,11,11,11,11,11,11,11,11,11,11,11,11,11,11,11,11,11
11,11,11,11,11,11,11,11,11,11,11,11,11,11,11,11,11,11,11,11,11,11,11,11,11
