11,11,11,11,11,11,11,11,11,11,11,11,11,11,11,11,11,11,11,11,11,11,11,11,11
11,11,11,11,11,12,12,12,11,11,11,11,11,11,11,11,11,11,11,11,11,11,11,11,11
11,11,11,12,12,12,12,12,12,12,12,12,12,11,11,11,11,12,12,11,11,11,11,11,11
11,11,11,12,12,12,12,12,12,12,12,12,12,12,12,12,12,12,12,12,12,12,12,11,11
11,11,11,12,12,12,12,12,12,12,12,12,12,12,12,12,12,12,12,12,12,12,12,11,11
11,11,12,12,12,12,12,12,12,12,12,12,12,12,12,12,12,12,12,12,12,12,12,12,12
11,12,12,12,12,12,12,12,12,12,12,12,12,12,12,12,12,12,12,12,12,12,12,12,12
11,12,12,12,12,12,12,12,12,12,12,12,12,12,12,12,12,12,12,12,12,12,12,12,12
11,12,12,12,12,12,10,10,10,10,10,10,10,10,10,10,10,10,12,12,12,12,12,12,12
11,11,12,12,12,10,10,10,10,10,10,12,12,12,10,10,10,10,10,12,12,12,12,12,12
12,11,12,12,10,10,10,10,10,10,10,12,12,12,12,10,10,10,10,10,12,12,12,12,12
12,12,12,10,10,10,10,10,10,10,12,12,12,12,12,12,10,10,10,10,10,12,12,12,12
12,12,12,10,10,10,10,10,12,10,10,10,10,10,10,10,12,10,10,10,10,12,12,12,12
12,12,12,10,10,10,10,12,12,10,11,11,11,11,12,10,10,10,10,10,10,12,12,12,12
12,12,12,10,10,10,12,10,10,11,11,11,11,11,11,12,10,10,10,10,10,12,12,12,12
12,12,12,10,10,10,10,10,11,11,11,11,11,11,11,11,10,10,10,10,10,12,12,12,12
12,12,12,10,10,12,10,10,11,11,11,11,11,11,11,10,10,10,10,10,10,12,12,12,12
12,12,12,10,10,10,12,10,10,10,11,11,11,11,10,10,10,10,10,10,10,12,12,12,12
12,12,12,10,10,10,10,12,10,10,10,12,10,10,10,10,10,10,12,10,10,10,12,12,12
12,12,12,10,10,10,10,10,10,10,12,12,10,10,10,12,12,12,10,10,10,10,12,12,12
12,12,12,12,10,10,10,10,10,10,10,12,10,10,12,10,12,12,10,10,10,10,10,2,2
12,12,12,12,12,10,10,10,10,10,10,10,10,10,10,10,10,10,12,10,10,10,10,2,2
12,12,12,12,12,12,10,10,10,10,10,10,10,10,10,10,10,10,10,10,10,10,10,2,2
12,12,12,12,12,12,12,12,12,12,12,12,12,12,12,12,12,12,10,10,10,10,10,2,12
12,12,12,12,12,12,12,12,12,12,12,12,12,12,12,12,12,12,12,12,10,10,10,2,12
